NO ./sprites/Walls/North.xpm
SO ./sprites/Walls/South.xpm
WE ./sprites/Walls/West.xpm
EA ./sprites/Walls/East.xpm

F 0,0,255
C 11,0,46

        1111111111111111111111111
        1000000000110000000000001
        1011000001110000000000001
        1001000000000000000000011111111
11111111101100S001110000000000001111101
100000000011000001110111111111111111111
11110111111111011100000010001
11110111111111011101010010001
11000000110101011100000010001
10000000000001231100000010001
10000000000000001101010010001
11000001110101011111011110011
11110111 1110101 101111010001
11111111 1111111 111111111111