NO ./sprites/Walls/North.xpm
SO ./sprites/Walls/South.xpm
WE ./sprites/Walls/West.xpm
EA ./sprites/Walls/East.xpm

F 0,0,0
C 0,0,128

        1111111111111111111111111
        1E00000000110000000000001
        1011000001110000000000001
        1001000000000000000000011111111
111111111011000001110000000000001111101
100000000011000001110111111111111
11110111111111011100000010001
11110111111111011101010010001
11000000110101011100000010001
10000000000000001100000010001
10000000000000001101010010001
110000011101010111110111100111
11110111 1110101 101111010001
11111111 1111111 111111111111