NO ./sprites/Walls/North.xpm
SO ./sprites/Walls/South.xpm
WE ./sprites/Walls/West.xpm
EA ./sprites/Walls/East.xpm

F 0,0,0
C 0,0,128

111111111111111111111111111111
100000000000000000000000000001
100000000000000000000000000001
100000000000000000000000000001
100000000000000000000000000001
100000000000000000000000000001
100000000000000000000000000001
100000000000000000300000000001
100000000000000000300000000001
100000000000000000300000000001
100000000000000N00000000000001
100000000000000000000000000001
100000000000000000000000000001
100000000000000000000000000001
100000000000000000000000000001
100000000000000000000000000001
120000000000000000000000000001
111111111111111111111111111111

