NO ./sprites/Walls/North.xpm
SO ./sprites/Walls/South.xpm
WE ./sprites/Walls/West.xpm
EA ./sprites/Walls/East.xpm

F 0,0,0
C 0,0,128

1111111
1200001
100N001
1000001
1000001
1000001
1000001
1000001
1000001
1000001
1000001
1000001
1111111