NO ./sprites/Walls/North.xpm
C 3,3,128
SO ./sprites/Walls/South.xpm



EA ./sprites/Walls/East.xpm


F 3,3,3



WE ./sprites/Walls/West.xpm


111111111111111111111111111111
133333333333333333333333333331
133333333333333333333333333331
133333333333333333333333333331
133333333333333333333333333331
133333333333333333333333333331
133333333333333333333333333331
133333333333333333333333333331
133333333333333333333333333331
133333333333333333333333333331
133333333333333N33333333333331
133333333333333333333333333331
133333333333333333333333333331
133333333333333333333333333331
133333333333333333333333333331
133333333333333333333333333331
123333333333333333333333333331
111111111111111111111111111111
